Lamp oil, rope, bombs You want it?
It's yours my friend
As long as you have enough rubies

Sorry link, i can't give credit
come back when you're a little MMMMMMMMMMMMMM richer!

I'm  - I am
I'll - I will
I've - I have
you're - you are
you’ll - you will
you’ve - you have
he’ll - he will
she’ll - she will
it’ll - it will
we’re - we are
we’ll - we will
we’ve - we have
they’re - they are
they’ll - they will
they’ve - they have
there’ll - there will
isn’t - is not
aren’t - are not
don’t - do not
doesn’t - does not
wasn’t - was not
weren’t - were not
didn’t - did not
haven’t - have not
hasn’t - has not
won’t - will not
hadn’t - had not
can’t - cannot
couldn’t - could not
mustn’t - must not
mightn’t - might not
needn’t - need not
shouldn’t - should not
oughtn’t - ought not
wouldn’t - would not
What’s - What is
How’s - How is
Where’s - Where is